                                                                                                                                                                              
                                                                                                                       
                                                                                                                       
                                                                                                                       
                                                                                                                       
         n==================================================================================================N           
         |                                                                                                  I          
         |                                                                                                  I          
         |                                                                                                  I          
         |                                                                                                  I          
         |                                                                                                  I          
         |                                                                     hhhch                        I          
         |                                                                     h0tCh                        I          
         |                                                                     h000h                        I          
         |                                                                     h000h                        I          
         |                                                                     h000h                        I          
         |                                                                     h000h                        I          
         |                                                                     h0T0h                        I          
         |                                                                     hh0hh                        I          
         |                                                                       F                          I          
         |                        wwwwwwwwwwwwwwwwwwwwwwwwwwwwww                                            I          
         |                        w0000000000000000000000000000w                                            I          
         |                        w0000000000000000000000000000w                                            I          
         |                        w0000000000000000000000000000w                                            I          
         |                        w0000000000000000000000000000w                                            I          
         |                        w0000000000000000000000000000w                                            I          
         |                        w0000000000000000000000000000w                                            I          
         |                        w0000000000000000000000000000w                                            I          
         |                        w0000000000000000000000000000w                                            I          
         |                        w0000000000000000000000000000w                                            I               
         |                        w0000000000000000000000000000w                                            I          
         |                        w0000000000000000000000000000w                                            I          
         |                        w0000000000000000000000000000w                                            I          
         |                        w00000000000000T0000000000000w                                            I          
         |                        wwwwwwwowwwwwwwdwwwwwwwowwwwww                                            I          
         |                        WWWWWWWWWWWWWWWDWWWWWWWWWWWWWW                                            I          
         |                                                                                                  I          
         |                                       F                                                          I          
         |                                                                                                  I          
         |                                                                                                  I          
         |                                                                                                  I          
         |                                                                                                  I          
         |                                                                                                  I          
         |                                                                                                  I          
         |                                                                                                  I          
         |                                                                                                  I          
         |                                                                                                  I          
         |                                                                                                  I          
         |                                                                                                  I          
         |                                                                                                  I          
         |                                                                                                  I          
         |                                                                                                  I          
         |                                                                                                  I          
         |                                                                                                  I          
         s-------------------------------------]   [--------------------------------------------------------S          
                                                                                                                       
                                                                                                                       
                                                                                                                       
                                                                                                                       
                                                                                                                       